1111111111111111111
1777777771777777771
1611711171711171161
1777777777777777771
1711717111117171171
1777717771777177771
1111711101011171111
0001710000000171000
1111710113110171111
0000700133310070000
1111710111110171111
0001710000000171000
1111710111110171111
1777777771777777771
1711711171711171171
1671777770777771761
1171717111117171711
1777717771777177771
1777777777777777771
1111111111111111111
